****************** ******************* *
*             **** **             **** *
* ***** *****   ** ** ***** *****   ** *
* ***** ******* ** ** ***** ******* ** *
* *          ** ** ** *          ** ** *
* ********** **    ** ********** **    *
************ ******************* *******
************ ***** ************* ***** *
*             ****                **** *
* ***** *****   ** ** ***** *****   ** *
* ***** ******* ** ** ***** ******* ** *
* *          ** ** ** *          ** ** *
* ********** **    ** ********** **    *
****************************************
