****************** *
*     *       **** *
* ***** *****   ** *
* ***** ******* ** *
* *          ** ** *
* ********** **    *
************ *******
